Pos	Qual	Freq	Ref	Base	UngappedCoverage	TotalCoverage	VariantCov	ForwardVariantCov	ReverseVariantCov	RefCov	ForwardRefCov	ReverseRefCov	replica	State	Decision	SB	GATK_SB	Fisher_SB
1070	0	0.09293320425943853	C	T	1033	1034	96	49	47	936	557	379	a	TRUE	1	0.31680844140752107	0.11180846325874914	0.8727128016294501
1129	0	0.038391224862888484	G	A	547	550	21	19	2	524	135	389	a	FALSE	0	3.069168378813976	0.12766473242889165	0.999999998069237
1175	0	0.2489451476793249	A	G	474	513	118	105	13	356	55	301	a	TRUE	1	2.4698160693079996	0.8375958321405568	1
1176	0	0.043478260869565216	G	A	667	669	29	29	0	638	180	458	a	FALSE	0	3.1913875598086126	0.14506307090039147	0.9999999999999994
1183	0	0.031007751937984496	C	T	387	391	12	4	8	367	366	1	a	FALSE	0	27.73263263263263	0.9080295554409995	0.9999999999995498
1187	0	0.11406844106463879	T	G	263	353	30	29	1	233	207	26	a	TRUE	1	0.7525685289809584	0.13356584197494942	0.6668687700103993
1229	0	0.24561403508771928	G	A	114	131	28	28	0	84	63	21	a	FALSE	0	1.2307692307692308	0.4102564102564103	0.9983995497546604
1337	0	0.07662835249042145	A	T	2088	2096	160	74	86	1926	991	935	a	TRUE	1	0.19227154635288063	0.08488965668093416	0.7824618015663809
1343	0	0.06656580937972768	C	T	1322	1330	88	39	49	1206	83	1123	a	TRUE	1	4.085852898989334	0.32865775887529286	1
1442	0	0.08365508365508366	C	T	777	779	65	35	30	712	488	224	a	TRUE	1	0.6119010090645567	0.12026706052251987	0.9812343030548953
1457	0	0.033932135728542916	T	C	501	507	17	0	17	484	269	215	a	FALSE	0	2.1594827586206895	0.07584960102593331	0.9999985057723372
1475	0	0.06752873563218391	A	G	696	696	47	4	43	648	293	355	a	TRUE	1	1.3984610710260235	0.11431582456072187	0.999999844402927
1499	0	0.10093457943925234	G	A	535	542	54	10	44	480	126	354	a	TRUE	1	0.36611981476007494	0.11394657109074788	0.7488127189908733
1517	0	0.053763440860215055	G	T	93	97	5	0	5	88	65	23	a	FALSE	0	3.3214285714285716	0.18871753246753245	0.9981089556707692
1522	0	0.16312056737588654	G	T	141	143	23	10	13	118	16	102	a	FALSE	0	1.6648538606950705	0.407629952950513	0.9979909982096083
1586	0	0.19047619047619047	C	T	168	203	32	1	31	135	96	39	a	FALSE	0	2.2573591678939615	0.5421829487808869	0.9999999999996697
1622	0	0.05181347150259067	G	A	386	396	20	15	5	365	24	341	a	FALSE	0	7.125666963094709	0.39982762506319397	0.99999999999919
1655	0	0.13338856669428334	C	T	1207	1207	161	86	75	1045	569	476	a	TRUE	1	0.03609342662652474	0.1364619736840448	0.13490891824170703
1664	0	0.09939759036144578	A	G	664	669	66	66	0	595	113	482	a	FALSE	0	3.6927374301675977	0.40961457208581753	1
1665	0	0.06385281385281386	G	A	924	927	59	58	1	862	171	691	a	FALSE	0	3.931109333734918	0.2702195886401154	1
1736	0	0.07319952774498228	A	G	847	847	62	23	39	785	366	419	a	TRUE	1	0.3555606876090663	0.08644589333532203	0.814730062530842
1756	0	0.03164556962025317	G	A	316	321	10	10	0	306	5	301	a	FALSE	0	21.066666666666663	0.6884531590413943	0.9999999999999988
1768	0	0.030612244897959183	C	A	392	392	12	0	12	380	102	278	a	FALSE	0	1.3517241379310345	0.04268602540834846	0.9583887402996004
1840	0	0.08974358974358974	A	G	156	158	14	14	0	142	10	132	a	FALSE	0	6.5	0.6408450704225352	0.9999999999999383
1895	0	0.03048780487804878	C	T	164	175	5	0	5	158	99	59	a	FALSE	0	2.546875	0.08059731012658228	0.9915404415321374
2648	0	0.17275280898876405	T	G	712	732	123	58	65	589	495	94	a	TRUE	1	1.7592916370666316	0.44234487387216165	0.9999999999999999
2654	0	0.07042253521126761	C	T	568	570	40	40	0	524	511	13	a	TRUE	1	1.0235934664246824	0.07813690583394522	0.3861493532201665
2655	0	0.07255520504731862	G	A	317	321	23	22	1	294	213	81	a	FALSE	0	1.1222061776584462	0.09970981646420893	0.9878792167078659
2773	0	0.07378335949764521	A	C	637	641	47	30	17	590	350	240	a	FALSE	0	0.17347418965494696	0.07959819088709705	0.3563760094577145
2811	0	0.048143053645116916	G	C	1454	1459	70	0	70	1380	1054	326	a	FALSE	0	3.6616161616161618	0.18573415312545746	1
2812	0	0.05118411000763942	T	A	1309	1371	67	0	67	1236	1044	192	a	FALSE	0	5.030888030888031	0.2727099498944159	1
2828	0	0.16829745596868884	C	T	1022	1022	172	89	83	849	114	735	a	TRUE	1	2.0001903625634814	0.47374654530407134	1
2842	0	0.265625	G	T	256	270	68	1	67	186	159	27	a	FALSE	0	2.6390448998748433	0.9672636410432395	1
2864	0	0.1415327564894932	A	G	1618	1637	229	98	131	1389	365	1024	a	TRUE	1	0.6941372158043383	0.21859454934946257	0.999999189521386
3022	0	0.032520325203252036	A	G	246	264	8	7	1	238	38	200	a	FALSE	0	4.6303482587064675	0.1599843917666569	0.9999685092952878
3038	0	0.100169779286927	T	C	1178	1178	118	79	39	1059	613	446	a	TRUE	1	0.3366367481786806	0.11667951619594961	0.9386876427874942
3050	0	0.08069458631256383	T	C	979	982	79	59	20	899	460	439	a	TRUE	1	0.8679090084364273	0.11828118083245337	0.9999474174529941
4082	0	0.14942528735632185	G	T	261	262	39	37	2	222	60	162	a	FALSE	0	2.471122415427167	0.44298466180538093	0.9999999999999998
4085	0	0.0956140350877193	T	C	1140	1140	109	75	34	1030	494	536	a	TRUE	1	0.75405008546907	0.1370646402037479	0.9999675233291627
4093	0	0.05154639175257732	T	C	97	98	5	5	0	92	86	6	a	FALSE	0	1.065934065934066	0.057931199235547064	0
4094	0	0.5060975609756098	C	T	164	167	83	60	23	81	80	1	a	TRUE	1	1.0467584624211133	1.1087595532039975	0.9999994038066713
4105	0	0.059447983014861996	G	A	471	471	28	2	26	443	118	325	a	FALSE	0	0.9656746031746032	0.07744335757879775	0.9766486040889499
4106	0	0.10831721470019343	A	G	517	517	56	3	53	461	89	372	a	TRUE	1	0.8502543843624407	0.13529406216886453	0.9913853031711681
4113	0	0.05565217391304348	A	G	575	579	32	32	0	543	192	351	a	FALSE	0	2.5669642857142856	0.15127598000526177	0.9999999999999813
4153	0	0.03284072249589491	T	C	609	611	20	1	19	589	319	270	a	FALSE	0	1.9067468641868508	0.06776391059270007	0.9999922788310776
4210	0	0.04417670682730924	G	A	249	256	11	10	1	237	52	185	a	FALSE	0	3.515151515151515	0.16786897146227484	0.9999953033409749
4213	0	0.03125	G	T	160	162	5	5	0	151	6	145	a	FALSE	0	14.181818181818183	0.4695966285370259	0.9999993598066104
4214	0	0.045454545454545456	T	A	22	40	1	0	1	21	19	2	a	FALSE	0	7.333333333333333	0.3492063492063492	0.8636363636363635
4230	0	0.030042918454935622	C	G	233	234	7	0	7	225	123	102	a	FALSE	0	2.128440366972477	0.06621814475025485	0.9954515090706808
4234	0	0.09210526315789473	C	T	76	87	7	0	7	65	12	53	a	FALSE	0	1.2	0.12923076923076923	0.4078218467835172
4235	0	0.03125	T	C	96	157	3	0	3	91	1	90	a	FALSE	0	1.010752688172043	0.03332151719248493	1.1102230246251565e-16
4238	0	0.1949685534591195	C	T	477	489	93	44	49	384	50	334	a	TRUE	1	1.7446288826248004	0.5070603716460197	0.9999999999945147
4242	0	0.03461538461538462	G	A	260	267	9	9	0	251	5	246	a	FALSE	0	18.571428571428573	0.665907797381901	0.9999999999998461
4705	0	0.03185840707964602	T	C	565	569	18	0	18	545	480	65	a	FALSE	0	6.783132530120482	0.22403006521498842	0.9999999999999998
4725	0	0.04040404040404041	G	T	198	200	8	8	0	188	17	171	a	FALSE	0	7.840000000000001	0.33361702127659576	0.9999999768592495
4751	0	0.05929919137466307	T	C	742	744	44	29	15	698	472	226	a	TRUE	1	0.07346529122065183	0.062334283507080174	0.13156132730569603
4757	0	0.08058608058608059	T	C	546	553	44	2	42	499	354	145	a	FALSE	0	2.702424033036002	0.24303019305449813	1
4775	0	0.10648148148148148	A	G	216	221	23	1	22	193	41	152	a	FALSE	0	0.9638038123795246	0.1381352255034585	0.9456766695726735
4776	0	0.0547945205479452	G	C	365	370	20	0	20	344	111	233	a	FALSE	0	1.4387351778656128	0.08364739406195423	0.999244220465582
4867	0	0.14626865671641792	T	C	335	360	49	0	49	286	252	34	a	FALSE	0	4.036144578313253	0.69150728789283	1
5591	0	0.20995670995670995	T	C	924	931	194	160	34	730	539	191	a	TRUE	1	0.370492161113815	0.24594770089037832	0.9858066394200564
5633	0	0.037168141592920353	C	T	1130	1130	42	0	42	1088	655	433	a	FALSE	0	2.3789473684210525	0.0918343653250774	1
5717	0	0.14953271028037382	C	T	1177	1178	176	54	122	999	375	624	a	TRUE	1	0.2514549945545557	0.16813857296431026	0.910462622738106
5817	0	0.049008168028004666	G	A	857	883	42	41	1	815	13	802	a	FALSE	0	15.467093746774113	0.797392475331798	1
5828	0	0.0978494623655914	T	C	2790	2791	273	234	39	2517	1359	1158	a	TRUE	1	1.1682353583717162	0.15751991846042046	1
5871	0	0.03581267217630854	G	A	726	737	26	26	0	699	90	609	a	FALSE	0	6.25	0.23247496423462088	1
5906	0	0.03343465045592705	G	A	329	360	11	11	0	311	109	202	a	FALSE	0	2.683333333333333	0.09490889603429796	0.9999857289895622
6056	0	0.10589651022864019	C	T	831	833	88	26	62	742	339	403	a	TRUE	1	0.5857202158572021	0.13852232027471106	0.995651563039509
6804	0	0.042826552462526764	C	T	467	469	20	0	20	447	181	266	a	FALSE	0	1.6328671328671331	0.07305893211933481	0.9999378715669531
6890	0	0.1413237924865832	A	G	559	582	79	57	22	480	139	341	a	TRUE	1	1.628956185466131	0.3181537956091528	0.9999999999995306
6944	0	0.1424731182795699	G	A	372	379	53	49	4	319	0	319	a	FALSE	0	6.931946959518663	1.151702786377709	1
6985	0	0.07540702656383891	C	A	1167	1169	88	1	87	1079	780	299	a	FALSE	0	2.9719802187854136	0.24345849227218092	1
6993	0	0.03863845446182153	G	A	1087	1106	42	42	0	1043	603	440	a	FALSE	0	1.6821705426356588	0.06773841111284533	0.9999999997137874
7037	0	0.09008145663632007	C	T	2087	2089	188	127	61	1899	1282	617	a	TRUE	1	0.0018244147099833706	0.09014583842251302	0
7094	0	0.14513556618819776	C	T	627	628	91	72	19	534	498	36	a	TRUE	1	1.505073873494926	0.35325161729656107	0.9999249075851843
7107	0	0.030501089324618737	T	A	459	459	14	1	13	443	261	182	a	FALSE	0	2.0515994183933115	0.06851101959230092	0.9998936166359652
7108	0	0.4936708860759494	A	T	237	237	117	117	0	117	59	58	a	FALSE	0	1.3295454545454546	1.3295454545454546	1
7112	0	0.03058823529411765	C	G	425	430	13	11	2	405	215	190	a	FALSE	0	1.2300743135920127	0.049711615499471944	0.9563227365746656
7148	0	0.16731016731016732	T	C	777	777	130	72	58	646	347	299	a	TRUE	1	0.05594794554502532	0.17288234666987223	0.22736351958417733
7151	0	0.19801980198019803	C	T	505	506	100	52	48	404	182	222	a	TRUE	1	0.22399999999999992	0.22794279427942793	0.7800804015824443
7155	0	0.049253731343283584	G	A	670	671	33	32	1	634	127	507	a	FALSE	0	4.028060654082048	0.21131663047803212	1
7156	0	0.047520661157024795	G	A	484	484	23	23	0	460	141	319	a	FALSE	0	2.945121951219513	0.14725609756097563	0.9999999999945195
7168	0	0.031578947368421054	C	T	760	773	24	1	23	735	659	76	a	FALSE	0	7.299305555555556	0.2395457981172267	1
7175	0	0.13783783783783785	C	T	740	743	102	63	39	638	350	288	a	TRUE	1	0.2414164235123376	0.15582827887451509	0.8005194904608164
7204	0	0.05846153846153846	T	C	325	328	19	1	18	306	183	123	a	FALSE	0	2.090687229173767	0.1348492681068727	0.9999981817281577
7208	0	0.03818615751789976	A	G	419	428	16	16	0	403	61	342	a	FALSE	0	5.441558441558442	0.2160420224936354	0.99999999999957645
7214	0	0.030303030303030304	C	T	528	529	16	0	16	512	384	128	a	FALSE	0	3.6666666666666665	0.11458333333333333	0.9999999995037544
7220	0	0.03980099502487562	A	T	201	202	8	6	2	188	81	107	a	FALSE	0	1.2401138880101235	0.0705809500090868	0.8579363889869204
7234	0	0.06976744186046512	T	G	86	107	6	0	6	80	9	71	a	FALSE	0	1.1168831168831168	0.08376623376623377	0
7240	0	0.07971014492753623	T	C	138	156	11	0	11	127	48	79	a	FALSE	0	1.5333333333333334	0.13280839895013125	0.9914937438604342
7281	0	0.03208556149732621	T	C	374	407	12	12	0	360	107	253	a	FALSE	0	3.1260504201680672	0.10420168067226891	0.9999992257497732
7293	0	0.043161434977578475	C	T	1784	1785	77	3	74	1705	1464	241	a	FALSE	0	5.38940778765494	0.24502784767182156	1
7379	0	0.07106598984771574	T	C	985	1017	70	2	68	914	663	251	a	FALSE	0	2.9542298199596617	0.2288015780380965	1
7407	0	0.10144927536231885	C	A	138	148	14	13	1	123	20	103	a	FALSE	0	3.760884948384948	0.4345590046809559	0.9999999872355084
7447	0	0.06716417910447761	T	A	268	269	18	0	18	249	177	72	a	FALSE	0	2.966666666666667	0.21445783132530122	0.9999999990833046
7451	0	0.09481216457960644	C	T	559	567	53	34	19	504	337	167	a	TRUE	1	0.11041561056490035	0.10254660970359605	0.24032261822211087
7455	0	0.03565891472868217	T	C	645	657	23	1	22	622	491	131	a	FALSE	0	3.975396627367808	0.14880480987522188	0.9999999999999033
7493	0	0.09929078014184398	G	T	282	282	28	11	17	253	143	110	a	TRUE	1	0.6265265948899247	0.1380531484947781	0.8913051535334382
7505	0	0.11095305832147938	T	C	703	716	78	40	38	625	468	157	a	TRUE	1	1.0466736036693638	0.20193259842519684	0.999958878461312
7538	0	0.04769001490312966	A	G	671	675	32	18	14	639	177	462	a	TRUE	1	1.3188489819004525	0.09407940857816582	0.9989173474167145
7568	0	0.08996539792387544	T	C	578	605	52	32	20	524	303	221	a	TRUE	1	0.13884741628594982	0.09628787423939501	0.339983014561131
8007	0	0.0858806404657933	G	A	687	688	59	21	38	626	333	293	a	TRUE	1	0.6441506807346918	0.11817151751217203	0.9864012610228946
8048	0	0.1382488479262673	G	A	217	218	30	30	0	187	2	185	a	FALSE	0	6.781249999999999	1.0879010695187166	1
8050	0	0.07344632768361582	G	T	177	177	13	13	0	164	14	150	a	FALSE	0	6.5555555555555545	0.5196476964769647	0.9999999999988278
8097	0	0.04859335038363171	C	T	391	393	19	1	18	371	245	126	a	FALSE	0	2.4823491655969194	0.13086746433502072	0.9999998967977665
8105	0	0.07983193277310924	C	T	952	952	76	36	40	874	543	331	a	TRUE	1	0.5705068223398462	0.10990552375446984	0.9860446505559479
8108	0	0.0635593220338983	A	G	472	482	30	30	0	437	152	285	a	FALSE	0	2.5659340659340657	0.17615108004124022	0.9999999999998912
8124	0	0.0364741641337386	A	G	658	668	24	24	0	634	225	409	a	FALSE	0	2.6425702811244984	0.10003420622553305	0.9999999999638216
8185	0	0.037209302325581395	A	G	215	217	8	0	8	207	121	86	a	FALSE	0	2.2872340425531914	0.08839551855278034	0.9988785100297565
9200	0	0.03286978508217446	G	A	791	794	26	22	4	765	515	250	a	TRUE	1	0.7672794660873665	0.041693632638126386	0.9144485366355415
9225	0	0.1127129750982962	C	T	763	764	86	54	32	677	207	470	a	TRUE	1	1.2700537065850472	0.21831484229637757	0.9999999887973521
9242	0	0.08011869436201781	T	C	674	675	54	16	38	616	437	179	a	TRUE	1	1.7344949959063753	0.18373893225115492	0.9999999971578495
9272	0	0.09165808444902163	C	T	971	971	89	33	56	882	443	439	a	TRUE	1	0.4779020017949298	0.11591249294330529	0.980533294569851
9277	0	0.05241379310344828	C	T	725	726	38	0	38	684	602	82	a	FALSE	0	6.016666666666667	0.33425925925925926	1
9296	0	0.1278772378516624	T	C	782	783	100	43	57	680	147	533	a	TRUE	1	1.0117038358608388	0.23451776250196776	0.9999901255959146
9818	0	0.13247863247863248	G	A	234	253	31	30	1	203	33	170	a	FALSE	0	3.5503274314819304	0.5456992234280281	1
9834	0	0.04316546762589928	G	A	278	283	12	12	0	264	174	90	a	FALSE	0	1.4838709677419355	0.06744868035190615	0.9895552435168815
9887	0	0.04961505560307956	C	T	1169	1169	58	43	15	1111	475	636	a	TRUE	1	1.208707873613324	0.08533265831253693	0.999995821095494
9899	0	0.12429378531073447	A	G	177	193	22	19	3	153	68	85	a	TRUE	1	1.466021896076755	0.2412777197259956	0.9998017559050184
9905	0	0.03800475059382423	G	A	421	426	16	16	0	404	224	180	a	FALSE	0	1.7499999999999998	0.0693069306930693	0.9998753428383211
9927	0	0.03298350824587706	G	T	667	668	22	22	0	645	251	394	a	FALSE	0	2.4432234432234434	0.08333475310219497	0.9999999982648585
9928	0	0.0436241610738255	C	T	298	305	13	0	13	283	134	149	a	FALSE	0	1.8271604938271604	0.08393316756096497	0.9996609920439022
9934	0	0.05	T	C	360	372	18	0	18	341	132	209	a	FALSE	0	1.5814977973568283	0.08348082214786777	0.9997524165792318
9994	0	0.038871951219512195	T	C	1312	1324	51	0	51	1259	732	527	a	FALSE	0	2.26643598615917	0.0918095594075597	1
10185	0	0.05789473684210526	T	C	190	241	11	0	11	178	12	166	a	FALSE	0	1.0677966101694916	0.06598743096553038	0
10193	0	0.03143418467583497	A	G	509	512	16	4	12	493	261	232	a	FALSE	0	1.084360501082586	0.05001000709594076	0.9604558281361466
10198	0	0.07109004739336493	G	A	211	217	15	4	11	196	22	174	a	FALSE	0	1.327706167706168	0.15577241291527005	0.9041667220324714
10217	0	0.08602150537634409	A	G	744	749	64	32	32	679	390	289	a	TRUE	1	0.2769891187196408	0.1008129077887143	0.7088434839832798
10281	0	0.10568383658969804	G	A	1126	1126	119	64	55	1004	528	476	a	TRUE	1	0.04274905870120234	0.10839687009583694	0.1537056597412494
10286	0	0.1226252158894646	C	T	579	581	71	56	15	506	266	240	a	TRUE	1	0.9353049241742012	0.18665022290063987	0.9999794454008268
10314	0	0.05844155844155844	A	G	924	927	54	31	23	870	426	444	a	TRUE	1	0.3179785617338039	0.06849585670150882	0.7375058152330876
10319	0	0.08630952380952381	C	T	672	678	58	3	55	613	569	44	a	FALSE	0	6.366526672561156	0.6049309128428216	1
10324	0	0.053388090349075976	T	C	487	532	26	0	26	460	352	108	a	FALSE	0	3.626865671641791	0.20499675535366646	0.9999999999999996
10342	0	0.03359173126614987	A	T	387	389	13	13	0	372	259	113	a	FALSE	0	1.4154411764705883	0.049464342188488296	0.9870591299923075
10349	0	0.12947189097103917	T	C	587	594	76	53	23	510	212	298	a	TRUE	1	0.9896376455156585	0.21333822002321182	0.9999939027886544
10360	0	0.03564727954971857	C	T	533	533	19	3	16	514	211	303	a	FALSE	0	1.0137673527856204	0.051281659600958984	0.9687835146178827
10361	0	0.19157088122605365	T	C	522	548	100	39	61	422	208	214	a	TRUE	1	0.33368038277511974	0.23105830064173788	0.9253768856820168
10376	0	0.09026548672566372	G	A	565	566	51	29	22	514	408	106	a	TRUE	1	1.1689234475254633	0.1763911396237167	0.9993399360263535
10379	0	0.03956043956043956	A	G	455	460	18	0	18	437	194	243	a	FALSE	0	1.7432950191570882	0.07180620216207685	0.9999613795670239
1070	0	0.1493570722057369	C	T	1011	1013	151	80	71	860	521	339	b	TRUE	1	0.26821127550566526	0.17647794892800142	0.9122061378253976
1083	0	0.03225806451612903	C	A	341	344	11	0	11	323	141	182	b	FALSE	0	1.7305699481865284	0.05893581866889106	0.9968473474955043
1129	0	0.07407407407407407	G	A	486	487	36	35	1	450	86	364	b	FALSE	0	3.8679723763160876	0.31154081286086266	1
1175	0	0.3093812375249501	A	G	501	536	155	127	28	346	61	285	b	TRUE	1	1.8943457934703236	0.8906519461863107	1
1176	0	0.04852941176470588	G	A	680	681	33	33	0	647	179	468	b	FALSE	0	3.2075471698113205	0.16359977836750167	1
1187	0	0.14682539682539683	T	G	252	344	37	33	4	212	198	14	b	TRUE	1	0.5341055341055341	0.22371967654986522	0.6811560195453911
1215	0	0.03184713375796178	G	A	471	471	15	15	0	456	65	391	b	FALSE	0	5.8875	0.19366776315789475	0.9999999999991273
1229	0	0.20125786163522014	G	A	159	179	32	32	0	127	101	26	b	FALSE	0	1.1954887218045112	0.3012255047066485	0.9975170215229547
1308	0	0.030434782608695653	G	A	230	239	7	1	6	223	96	127	b	FALSE	0	1.143543689857929	0.046049199092224574	0.7566091474183391
1337	0	0.08500772797527048	A	T	1941	1950	165	56	109	1772	855	917	b	TRUE	1	0.5255363411948618	0.1089915372600909	0.9995659453910561
1343	0	0.077217125382263	C	T	1308	1314	101	47	54	1163	72	1091	b	TRUE	1	4.35262043249571	0.40901338415941757	1
1442	0	0.08935611038107753	C	T	761	762	68	43	25	692	459	233	b	TRUE	1	0.12564425381011307	0.09730536116054668	0.4055851077853522
1457	0	0.038539553752535496	T	C	493	496	19	1	18	472	243	229	b	FALSE	0	1.7773200755921794	0.07549731256883097	0.999942570111653
1475	0	0.05673758865248227	A	G	705	706	40	5	35	664	332	332	b	TRUE	1	1.417346518002248	0.0996127070885114	0.9999980245771553
1499	0	0.0914179104477612	G	A	536	547	49	13	36	484	128	356	b	TRUE	1	0.003936007750907457	0.09220830058768716	0
1516	0	0.04430379746835443	T	C	158	158	7	0	7	151	127	24	b	FALSE	0	5.096774193548387	0.23627430036317026	0.9999938305375807
1517	0	0.08421052631578947	G	T	95	98	8	0	8	87	66	21	b	FALSE	0	3.2758620689655173	0.30122869599682917	0.9999646885059463
1519	0	0.03187250996015936	G	A	251	251	8	7	1	243	75	168	b	FALSE	0	2.492702770962621	0.08765449916169116	0.9980573877919676
1522	0	0.1888111888111888	G	T	143	147	27	8	19	116	15	101	b	FALSE	0	1.0036097691894794	0.36089455272363824	0.956421221957365
1586	0	0.165	C	T	200	239	33	1	32	166	122	44	b	FALSE	0	2.490048106222689	0.500652159343407	0.9999999999999933
1655	0	0.14558823529411766	C	T	1360	1362	198	122	76	1159	655	504	b	TRUE	1	0.17805261598365044	0.15974885956737137	0.812875896737497
1664	0	0.09431524547803617	A	G	774	778	73	73	0	696	105	591	b	FALSE	0	4.320224719101124	0.45312701795169835	1
1665	0	0.06773283160865474	G	A	1063	1067	72	72	0	989	174	815	b	FALSE	0	4.3130081300813	0.31399048065303703	1
1736	0	0.09803921568627451	A	G	1020	1020	100	42	58	920	440	480	b	TRUE	1	0.21083157229017882	0.10910978514043969	0.7076791060816366
1768	0	0.03854389721627409	C	A	467	467	18	0	18	449	143	306	b	FALSE	0	1.441358024691358	0.05778272704776045	0.9973843081051667
1840	0	0.11290322580645161	A	G	186	187	21	21	0	165	17	148	b	FALSE	0	4.894736842105264	0.6229665071770336	1
2630	0	0.03015075376884422	G	A	199	209	6	5	1	192	123	69	b	FALSE	0	0.8176339285714286	0.039707728794642856	0.573356200363196
2648	0	0.17548746518105848	T	G	718	732	126	89	37	589	476	113	b	TRUE	1	0.5058599054174275	0.25226657852166817	0.9845389832950068
2654	0	0.09041591320072333	C	T	553	559	50	50	0	500	493	7	b	TRUE	1	1.0128913443830572	0.10128913443830571	0
2655	0	0.059880239520958084	G	A	334	338	20	20	0	314	232	82	b	FALSE	0	1.3253968253968254	0.08442017996158123	0.9945401637443406
2773	0	0.061285500747384154	A	C	669	672	41	23	18	628	362	266	b	FALSE	0	0.05939450449927949	0.06348461352946864	0.1285456001970845
2811	0	0.03608605135322693	G	C	1441	1447	52	1	51	1388	1060	328	b	FALSE	0	3.7003053248493036	0.13947439089836575	1
2812	0	0.04430863254392666	T	A	1309	1383	58	0	58	1248	1043	205	b	FALSE	0	4.965779467680608	0.2307814175684898	1
2828	0	0.18522483940042828	C	T	934	936	173	88	85	760	131	629	b	TRUE	1	1.525044398945737	0.4345692999622343	1
2842	0	0.2771929824561403	G	T	285	296	79	0	79	205	177	28	b	FALSE	0	2.6542056074766354	1.0228402097105083	1
2846	0	0.03684210526315789	G	A	380	383	14	3	11	365	6	359	b	FALSE	0	8.21898326898327	0.33582870541774645	0.9970272355003589
2864	0	0.14340344168260039	A	G	1569	1594	225	102	123	1343	376	967	b	TRUE	1	0.700687523191688	0.22102545688131703	0.9999995571694068
2884	0	0.03988035892323031	G	A	1003	1003	40	36	4	962	232	730	b	FALSE	0	3.2284131115539467	0.13915126424785215	1
3022	0	0.03982300884955752	A	G	226	239	9	9	0	216	33	183	b	FALSE	0	5.357142857142857	0.2232142857142857	0.9999998712554489
3038	0	0.1019163763066202	T	C	1148	1148	117	82	35	1030	574	456	b	TRUE	1	0.52660930945045	0.12927649140845907	0.9969838786765818
3050	0	0.09196515004840271	T	C	1033	1035	95	71	24	938	504	434	b	TRUE	1	0.7728635695941963	0.12885825287838384	0.9999188983170701
4082	0	0.10622710622710622	G	T	273	274	29	26	3	244	58	186	b	FALSE	0	2.764367816091954	0.34081446786364816	0.9999999999962816
4085	0	0.13144329896907217	T	C	1164	1165	153	101	52	1011	494	517	b	TRUE	1	0.5961467725723598	0.17757609831310037	0.999913788758833
4094	0	0.5838150289017341	C	T	173	179	101	81	20	72	71	1	b	TRUE	1	0.7185258939427775	1.0689049011417433	0.9998943563862511
4105	0	0.05927342256214149	G	A	523	523	31	4	27	492	141	351	b	FALSE	0	0.7396631177498807	0.07383455484801153	0.9367006881756905
4106	0	0.14	A	G	550	550	77	8	69	473	95	378	b	TRUE	1	0.5478036656768657	0.1655501188778657	0.95830753114409994
4113	0	0.05546218487394958	A	G	595	595	33	31	2	562	220	342	b	FALSE	0	2.1220228318579104	0.129997884815946	0.9999999998429581
4153	0	0.03035143769968051	T	C	626	632	19	3	16	607	359	248	b	FALSE	0	1.7237657176592915	0.06198513850493062	0.9998009625048904
4214	0	0.04	T	G	25	52	1	0	1	24	14	10	b	FALSE	0	2.272727272727273	0.09469696969696971	0.56
4234	0	0.10606060606060606	C	T	66	75	7	1	6	56	9	47	b	FALSE	0	0.11886792452830186	0.11462264150943398	0
4238	0	0.23221757322175732	C	T	478	485	111	47	64	364	60	304	b	TRUE	1	1.1354609383865784	0.4735131792222406	0.9999999448686615
4242	0	0.06741573033707865	G	A	267	269	18	18	0	249	2	247	b	FALSE	0	13.350000000000001	0.9650602409638555	1
4706	0	0.03669724770642202	A	G	436	440	16	16	0	420	215	205	b	FALSE	0	1.8874458874458873	0.07190270047412904	0.999965932978719
4725	0	0.031055900621118012	G	T	161	162	5	5	0	154	16	138	b	FALSE	0	7.571428571428571	0.2458256029684601	0.9999743956262732
4726	0	0.08333333333333333	T	G	48	68	4	1	3	44	31	13	b	FALSE	0	1.875	0.1981534090909091	0.8985507246376812
4733	0	0.08270676691729323	T	C	798	799	66	33	33	731	494	237	b	TRUE	1	0.7197589430037247	0.12491294680648246	0.9938227657583195
4751	0	0.0836940836940837	T	C	693	695	58	36	22	635	440	195	b	TRUE	1	0.30769482431459805	0.10227469194434188	0.699791458541135
4757	0	0.06324110671936758	T	C	506	513	32	0	32	472	358	114	b	FALSE	0	3.452054794520548	0.23403761318783375	1
4775	0	0.07	A	G	200	204	14	0	14	186	25	161	b	FALSE	0	1.1428571428571428	0.08602150537634408	0.7760383303028171
4776	0	0.060240963855421686	G	C	332	336	20	0	20	310	103	207	b	FALSE	0	1.4537444933920705	0.09378996731561745	0.9993025860825218
4867	0	0.10545454545454545	T	C	275	302	29	1	28	246	226	20	b	FALSE	0	5.4898349283508026	0.6492275825841959	1
5591	0	0.17558886509635974	T	C	934	944	164	134	30	770	587	183	b	TRUE	1	0.25632554502959026	0.19368552761531996	0.8489051669285059
5633	0	0.03089143865842895	C	T	1133	1134	35	0	35	1098	672	426	b	FALSE	0	2.457700650759219	0.07834200617174195	0.9999999999999903
5682	0	0.030685920577617327	G	T	1108	1113	34	1	33	1072	870	202	b	FALSE	0	4.53061274928908	0.14471299000028806	1
5717	0	0.14009661835748793	C	T	1242	1242	174	49	125	1066	388	678	b	TRUE	1	0.3102715536116717	0.1607715640688076	0.9602354032275637
5752	0	0.03758654797230465	G	A	1011	1011	38	16	22	973	489	484	b	FALSE	0	0.3138115413372	0.043744953609709245	0.5912980275317479
5817	0	0.04398148148148148	G	A	864	878	38	34	4	826	16	810	b	FALSE	0	15.34932367774473	0.7077880433812638	1
5828	0	0.1116820829051045	T	C	2919	2920	326	270	56	2590	1401	1189	b	TRUE	1	1.0429617181152049	0.173735101779055	1
5871	0	0.03954802259887006	G	A	708	716	28	28	0	679	103	576	b	FALSE	0	5.396946564885496	0.2225544975210514	1
5906	0	0.035211267605633804	G	A	284	324	10	10	0	271	74	197	b	FALSE	0	3.345238095238095	0.1234405201194869	0.9999961618980882
6053	0	0.03056768558951965	T	C	458	474	14	0	14	441	237	204	b	FALSE	0	2.0871559633027523	0.06625891946992865	0.999973158188712
6056	0	0.1303344867358708	C	T	867	871	113	47	66	752	345	407	b	TRUE	1	0.1503180506613018	0.1412583372042533	0.5814152937085766
6804	0	0.03090507726269316	C	T	453	454	14	1	13	438	179	259	b	FALSE	0	1.3637021475256768	0.04904777359954637	0.9890627240542615
6839	0	0.04	G	A	125	130	5	4	1	117	7	110	b	FALSE	0	8.652907452907453	0.37576037576037574	0.9998210605568859
6840	0	0.03211009174311927	C	A	218	232	7	4	3	210	171	39	b	FALSE	0	1.5057142857142858	0.07212244897959183	0.8661806985904636
6890	0	0.1168141592920354	A	G	565	590	66	36	30	499	161	338	b	TRUE	1	0.8664992175116871	0.19004351673994643	0.9994638127129749
6944	0	0.1450381679389313	G	A	393	400	57	56	1	335	0	335	b	FALSE	0	6.856725146198831	1.1666666666666667	1
6952	0	0.031073446327683617	T	C	354	360	11	1	10	336	282	54	b	FALSE	0	4.817509235464183	0.16079513187783948	0.9999997673709182
6979	0	0.03205128205128205	A	G	156	160	5	1	4	151	1	150	b	FALSE	0	14.78961038961039	0.5031392448610992	0.936724565756824
6985	0	0.0829576194770063	C	A	1109	1112	92	1	91	1017	712	305	b	FALSE	0	2.7531582595267885	0.2502345446240327	1
6993	0	0.03955841766329347	G	A	1087	1101	43	42	1	1041	610	431	b	FALSE	0	1.5655572465031735	0.06692274875961515	0.999999992152532
7037	0	0.05445151033386327	C	T	2516	2516	137	94	43	2379	1344	1035	b	TRUE	1	0.4679371527574845	0.06637533885565729	0.9942296185747164
7085	0	0.03441682600382409	A	G	523	532	18	18	0	505	129	376	b	FALSE	0	3.557823129251701	0.12681349767629824	0.9999999999455416
7094	0	0.1152542372881356	C	T	590	592	68	48	20	522	484	38	b	TRUE	1	2.2090469581662067	0.35458245296157553	0.9999992552971645
7108	0	0.45901639344262296	A	T	244	245	112	112	0	129	63	66	b	FALSE	0	1.3771428571428572	1.1956589147286822	1
7110	0	0.03597122302158273	T	C	278	321	10	1	9	266	256	10	b	FALSE	0	12.966291214417366	0.48957946781760875	0.9999999999602355
7113	0	0.04844961240310078	T	C	516	528	25	19	6	489	260	229	b	FALSE	0	0.8752071989628615	0.06975434702632786	0.9623765009126927
7148	0	0.0998766954377312	T	C	811	811	81	39	42	729	371	358	b	TRUE	1	0.098780487804878	0.1055691056910569	0.3581292744019794
7151	0	0.1443089430894309	C	T	492	494	71	31	40	421	169	252	b	TRUE	1	0.12482732008489296	0.1563264243646894	0.3972859278930523
7155	0	0.05194805194805195	G	A	616	617	32	30	2	582	46	536	b	FALSE	0	7.502684161612208	0.4148924797334232	1
7156	0	0.07459207459207459	G	A	429	432	32	32	0	395	60	335	b	FALSE	0	4.641304347826087	0.3760044028618602	1
7168	0	0.03629536921151439	C	T	799	814	29	0	29	770	666	104	b	FALSE	0	6.007518796992481	0.22625720144517136	1
7175	0	0.07942708333333333	C	T	768	769	61	30	31	707	350	357	b	TRUE	1	0.011954849096715061	0.07993854187372074	0
7204	0	0.04498269896193772	T	C	289	289	13	3	10	276	139	137	b	FALSE	0	1.0426330879047179	0.0697265025626499	0.9143464346824198
7214	0	0.039473684210526314	C	T	532	532	21	2	19	511	366	145	b	FALSE	0	2.7972781901732064	0.11995925274916835	0.9999999897541766
7240	0	0.07462686567164178	T	C	134	152	10	0	10	124	49	75	b	FALSE	0	1.5764705882352943	0.127134724857685	0.9865018035071622
7281	0	0.0330188679245283	T	C	424	455	14	12	2	409	116	293	b	FALSE	0	2.6277466707021793	0.09630169698727778	0.9999798287718521
7379	0	0.06763285024154589	T	C	1035	1060	70	1	69	964	669	295	b	FALSE	0	2.778031584620071	0.20302173131878337	1
7407	0	0.1259259259259259	C	A	135	142	17	17	0	114	22	92	b	FALSE	0	3.358974358974359	0.5008996851102114	0.9999999999455126
7415	0	0.04854368932038835	G	A	412	424	20	9	11	392	19	373	b	FALSE	0	6.0313244047619055	0.32815062408892126	0.9999991694934219
7447	0	0.0931899641577061	T	A	279	281	26	0	26	251	182	69	b	FALSE	0	2.9157894736842107	0.30203396938561544	0.9999999999999366
7451	0	0.09185441941074524	C	T	577	581	53	35	18	523	382	141	b	TRUE	1	0.31815515903404007	0.11421508920069111	0.6672298239049752
7455	0	0.039589442815249266	T	C	682	696	27	0	27	655	537	118	b	FALSE	0	4.703448275862069	0.19388260068439064	1
7493	0	0.09561752988047809	G	T	251	253	24	7	17	227	124	103	b	TRUE	1	0.9227549830364715	0.14827431594758494	0.9808311636860064
7505	0	0.10828877005347594	T	C	748	766	81	35	46	667	511	156	b	TRUE	1	1.5109619224030666	0.23900692456513556	0.9999999973456524
7538	0	0.04940119760479042	A	G	668	670	33	17	16	635	199	436	b	TRUE	1	0.8766077689381525	0.07986306283985888	0.9788273270495967
7568	0	0.09523809523809523	T	C	588	614	56	30	26	532	318	214	b	TRUE	1	0.23232758620689653	0.10941470054446462	0.6070123856107994
8007	0	0.08935611038107753	G	A	761	762	68	27	41	693	352	341	b	TRUE	1	0.4038866199203161	0.10946502220038255	0.9018666139203072
8022	0	0.03377110694183865	T	C	533	535	18	0	18	514	419	95	b	FALSE	0	4.707964601769912	0.16487035570400468	0.9999999999997521
8048	0	0.08733624454148471	G	A	229	233	20	19	1	209	3	206	b	FALSE	0	9.833322353974529	0.9417095859783607	1
8050	0	0.045	G	T	200	200	9	9	0	190	19	171	b	FALSE	0	7.107142857142858	0.3366541353383459	0.9999999938471349
8075	0	0.033816425120772944	G	A	621	622	21	21	0	597	127	470	b	FALSE	0	4.175675675675675	0.1468830639684911	0.9999999999999707
8097	0	0.03233256351039261	C	T	433	434	14	1	13	418	264	154	b	FALSE	0	2.285610988266056	0.0801479464110508	0.9999704928621925
8105	0	0.06314797360980208	C	T	1061	1062	67	38	29	994	576	418	b	TRUE	1	0.04731278787402201	0.06496412398708538	0.1015193130281965
8108	0	0.05150976909413854	A	G	563	569	29	28	1	531	169	362	b	FALSE	0	2.6914209967215075	0.14948143439457684	0.9999999999989477
8124	0	0.03117206982543641	A	G	802	814	25	25	0	777	288	489	b	FALSE	0	2.5623003194888176	0.08244209522164793	0.9999999999668243
8139	0	0.032397408207343416	G	A	463	470	15	13	2	447	5	442	b	FALSE	0	22.10570570570571	0.7430954444377263	1
8185	0	0.07581227436823104	A	G	277	279	21	0	21	253	158	95	b	FALSE	0	2.362068965517241	0.19606106037890145	0.9999999953738888
9200	0	0.030821917808219176	G	A	876	876	27	25	2	849	594	255	b	TRUE	1	1.0578712579806349	0.04134784053545043	0.9909822363513257
9225	0	0.08823529411764706	C	T	816	816	72	50	22	744	235	509	b	TRUE	1	1.5187497935044767	0.18444446576011136	0.9999999994886055
9242	0	0.06770098730606489	T	C	709	714	48	24	24	658	470	188	b	TRUE	1	0.9505194408372164	0.11556467365802023	0.9970362470068679
9272	0	0.06705539358600583	C	T	1029	1031	69	36	33	960	487	473	b	TRUE	1	0.05392945309704448	0.06896926178402196	0.09908015357093591
9277	0	0.04556962025316456	C	T	790	791	36	0	36	754	674	80	b	FALSE	0	6.810344827586207	0.3251623525107473	1
9296	0	0.10161090458488228	T	C	807	807	82	42	40	724	183	541	b	TRUE	1	1.1580829240306174	0.1935015198917216	0.9999967787612317
9758	0	0.0350609756097561	A	G	656	657	23	1	22	628	156	472	b	TRUE	1	1.080235044292238	0.04587140291802165	0.9766436196949579
9800	0	0.050816696914700546	C	T	551	552	28	4	24	523	465	58	b	FALSE	0	5.591747583634837	0.30572250505555115	1
9818	0	0.14601769911504425	G	A	226	263	33	32	1	193	22	171	b	FALSE	0	4.018544619319813	0.6898823151383701	1
9834	0	0.04721030042918455	G	A	233	235	11	11	0	219	143	76	b	FALSE	0	1.4935064935064934	0.07501630789302022	0.9822846862739439
9887	0	0.05536626916524702	C	T	1174	1174	65	36	29	1109	514	595	b	TRUE	1	0.3428113681190605	0.06607067414100778	0.8382561928018619
9899	0	0.14883720930232558	A	G	215	232	32	28	4	181	77	104	b	TRUE	1	1.5284722222222222	0.3021894822999795	0.9999983006269725
9905	0	0.04392764857881137	G	A	387	391	17	17	0	367	207	160	b	FALSE	0	1.714285714285714	0.079408330089529	0.9998473938724898
9928	0	0.06	C	T	250	261	15	0	15	231	113	118	b	FALSE	0	1.849624060150376	0.12010545845132312	0.9999278814473278
9934	0	0.05630026809651475	T	C	373	386	21	0	21	350	101	249	b	FALSE	0	1.374074074074074	0.08244444444444445	0.9983537109025037
9994	0	0.04045801526717557	T	C	1310	1327	53	1	52	1255	787	468	b	FALSE	0	2.436605689110239	0.10409084474285599	1
10185	0	0.08045977011494253	T	C	174	222	14	1	13	159	10	149	b	FALSE	0	0.13175404842071517	0.09097614862814023	0
10193	0	0.053169734151329244	A	G	489	492	26	4	22	463	242	221	b	FALSE	0	1.3969379010029417	0.09406423637870488	0.9997978119067875
10198	0	0.14009661835748793	G	A	207	208	29	2	27	178	22	156	b	FALSE	0	0.45830977953646124	0.1572803462884509	0.45934726400528303
10217	0	0.07116104868913857	A	G	801	804	57	34	23	742	437	305	b	TRUE	1	0.028944620237352097	0.07228145390369385	0
10226	0	0.03468208092485549	A	G	173	174	6	6	0	167	122	45	b	FALSE	0	1.3515625000000002	0.04855913173652694	0.658655468862074
10281	0	0.09615384615384616	G	A	1144	1146	110	56	54	1032	554	478	b	TRUE	1	0.10070862700716021	0.10201134269145987	0.38430142390363
10286	0	0.10159362549800798	C	T	502	505	51	43	8	448	228	220	b	TRUE	1	1.209183330223395	0.17053343113318348	0.9999973066693509
10314	0	0.0537280701754386	A	G	912	916	49	37	12	863	425	438	b	TRUE	1	0.9942645109992047	0.08237688923668066	0.9996520153370582
10319	0	0.08356940509915015	C	T	706	711	59	5	54	645	575	70	b	FALSE	0	5.093418299051677	0.4712212535892595	1
10324	0	0.05631067961165048	T	C	515	562	29	2	27	484	364	120	b	FALSE	0	3.152455555427372	0.19361487990400064	0.9999999999999181
10349	0	0.1425925925925926	T	C	540	545	77	49	28	462	216	246	b	TRUE	1	0.5790111554882247	0.19367855667263462	0.9932969663007305
10360	0	0.047244094488188976	C	T	381	381	18	1	17	362	172	190	b	FALSE	0	1.61173320426064	0.08571087836679708	0.9996579756284895
10361	0	0.18577981651376146	T	C	436	463	81	37	44	353	204	149	b	TRUE	1	0.398917281322917	0.23725944843833907	0.9374908241784415
10376	0	0.08586762075134168	G	A	559	563	48	31	17	511	423	88	b	TRUE	1	1.0903157995944341	0.16501941552675625	0.9942785765316293
10379	0	0.050997782705099776	A	G	451	453	23	0	23	428	213	215	b	FALSE	0	1.8949579831932775	0.10183185423702192	0.9999997401777758
1070	0	0.0855457227138643	C	T	1017	1019	87	49	38	930	516	414	c	TRUE	1	0.03103448275862061	0.08686554381958321	0.08942669310233042
1083	0	0.036939313984168866	C	A	379	382	14	0	14	359	134	225	c	FALSE	0	1.5606694560669456	0.060861761517931025	0.9971278005069628
1175	0	0.2260536398467433	A	G	522	554	118	104	14	404	64	340	c	TRUE	1	2.5635490622563304	0.7682257329849208	1
1176	0	0.05224963715529753	G	A	689	695	36	35	1	652	169	483	c	FALSE	0	3.2393813356380203	0.18066768866447355	1
1187	0	0.08235294117647059	T	G	255	347	21	15	6	234	203	31	c	TRUE	1	1.1335942757961108	0.16455587556504989	0.9039123032683651
1229	0	0.2746478873239437	G	A	142	158	39	39	0	102	80	22	c	FALSE	0	1.184873949579832	0.4530400395452298	0.9994791207492828
1308	0	0.034482758620689655	G	A	261	267	9	3	6	251	125	126	c	FALSE	0	0.6360479797979798	0.045980849329952916	0.4994393519774911
1337	0	0.05581835383159887	A	T	2114	2123	118	45	73	1996	1006	990	c	TRUE	1	0.4632383121273918	0.06961924453985069	0.9895913115216556
1343	0	0.05350686912509038	C	T	1383	1389	74	46	28	1272	88	1184	c	TRUE	1	5.823837728670003	0.3548624645624236	1
1403	0	0.040336134453781515	A	G	595	603	24	23	1	570	249	321	c	FALSE	0	2.0159675283156737	0.08784553295002212	0.9999998696901581
1442	0	0.08450704225352113	C	T	852	852	72	37	35	779	520	259	c	TRUE	1	0.6219430670732286	0.12141181872665638	0.9867040084999495
1457	0	0.04771371769383698	T	C	503	509	24	0	24	478	261	217	c	FALSE	0	2.0829875518672196	0.1045851490477265	0.999999987984514
1475	0	0.04781997187060478	A	G	711	715	34	9	25	677	311	366	c	TRUE	1	0.7489259722431174	0.06526113070300371	0.9670643189909713
1499	0	0.08671586715867159	G	A	542	546	47	16	31	492	120	372	c	TRUE	1	0.46702609030518916	0.11897141595850347	0.8397983117284568
1516	0	0.03164556962025317	T	C	158	159	5	2	3	149	127	22	c	FALSE	0	3.218480620155039	0.12210394880599343	0.969417203809183
1517	0	0.043478260869565216	G	T	115	118	5	1	4	109	78	31	c	FALSE	0	2.317106690777577	0.11801516332929642	0.9696119034731051
1522	0	0.2129032258064516	G	T	155	159	33	12	21	122	16	106	c	FALSE	0	1.2363227323857244	0.45446163491858593	0.9957905058521281
1586	0	0.1744186046511628	C	T	172	202	30	1	29	141	96	45	c	FALSE	0	2.1750208971858456	0.47037342233657214	0.9999999999875018
1619	0	0.031578947368421054	C	T	380	384	12	3	9	364	140	224	c	FALSE	0	0.5529577718418921	0.039062950915047315	0.4528870705766058
1622	0	0.03825136612021858	G	A	366	375	14	11	3	349	27	322	c	FALSE	0	7.266298438403703	0.2983065554563066	0.9999999988652039
1655	0	0.1205607476635514	C	T	1070	1071	129	79	50	939	498	441	c	TRUE	1	0.29044702184769405	0.13986660583184518	0.910143156730426
1664	0	0.07042253521126761	A	G	781	785	55	55	0	724	103	621	c	FALSE	0	4.9303797468354436	0.37454542275683617	1
1665	0	0.035634743875278395	G	A	898	901	32	32	0	865	161	704	c	FALSE	0	4.647668393782384	0.17193686543472403	1
1736	0	0.07407407407407407	A	G	513	513	38	15	23	475	216	259	c	TRUE	1	0.2244404531638576	0.0823652942801879	0.4971996732010605
1751	0	0.05555555555555555	A	G	36	36	2	2	0	34	32	2	c	FALSE	0	1.0588235294117647	0.06228373702422146	-2.220446049250313e-16
1752	0	0.05714285714285714	G	A	35	37	2	2	0	33	21	12	c	FALSE	0	1.5217391304347827	0.0922266139657444	0.46386554621848763
1840	0	0.07272727272727272	A	G	110	110	8	8	0	102	11	91	c	FALSE	0	5.7894736842105265	0.4540763673890609	0.9999998155212028
1891	0	0.03125	A	G	64	65	2	2	0	61	51	10	c	FALSE	0	1.1886792452830188	0.03897309000927931	0
1892	0	0.0392156862745098	C	A	102	102	4	0	4	97	93	4	c	FALSE	0	12.625	0.520618556701031	0.9999828554283999
1893	0	0.042105263157894736	T	C	95	101	4	0	4	90	90	0	c	FALSE	0	23.5	1.0444444444444443	0.9999996720774973
2648	0	0.15214180206794684	T	G	677	686	103	63	40	573	458	115	c	TRUE	1	0.9000855398054646	0.26763821322827763	0.9999309168959397
2654	0	0.08211678832116788	C	T	548	554	45	45	0	497	490	7	c	TRUE	1	1.0130841121495326	0.0917279377197766	0
2655	0	0.05537459283387622	G	A	307	311	17	17	0	289	195	94	c	FALSE	0	1.4433962264150944	0.08490566037735849	0.9978238214343553
2773	0	0.08842443729903537	A	C	622	624	55	27	28	567	272	295	c	FALSE	0	0.040867626114631024	0.09047308414652606	0.11146576094719074
2811	0	0.03365384615384615	G	C	1456	1458	49	3	46	1403	942	461	c	FALSE	0	2.5944922685895997	0.09360044467232362	1
2812	0	0.04291187739463601	T	A	1305	1343	56	0	56	1248	922	326	c	FALSE	0	3.4136125654450256	0.15317492280843065	1
2828	0	0.16118769883351008	C	T	943	943	152	78	74	790	103	687	c	TRUE	1	2.0680541168226103	0.46388669837970525	1
2839	0	0.030726256983240222	C	G	716	718	22	0	22	687	411	276	c	FALSE	0	2.379194630872483	0.07618963883434444	0.999999996715733
2842	0	0.26277372262773724	G	T	274	281	72	0	72	201	168	33	c	FALSE	0	2.6	0.9313432835820895	1
2864	0	0.11929595827900913	A	G	1534	1559	183	71	112	1350	325	1025	c	TRUE	1	0.6767658198840343	0.1835417845019135	0.9999552571277762
3038	0	0.08244111349036402	T	C	934	935	77	48	29	857	431	426	c	TRUE	1	0.4424067432716405	0.10225156898774387	0.9561337683719031
3039	0	0.030100334448160536	A	G	299	301	9	1	8	289	119	170	c	FALSE	0	1.2122138992925509	0.04595725930821767	0.910267896963211
3050	0	0.08705357142857142	T	C	896	897	78	53	25	817	335	482	c	TRUE	1	1.0015769838178792	0.14226045771942492	0.9999933131786418
4082	0	0.08503401360544217	G	T	294	297	25	22	3	269	64	205	c	FALSE	0	2.8387567084078715	0.275555958263229	0.9999999997732627
4085	0	0.07713248638838476	T	C	1102	1102	85	52	33	1015	456	559	c	TRUE	1	0.6033042074033274	0.10475056531260712	0.9955059914398414
4094	0	0.41935483870967744	C	T	155	155	65	41	24	90	89	1	c	TRUE	1	1.5371597633136094	1.1318974358974356	0.9999999992372859
4105	0	0.06981981981981981	G	A	444	444	31	4	27	412	109	303	c	FALSE	0	0.6633560843951938	0.08486026603347678	0.8671018414901636
4106	0	0.08901515151515152	A	G	528	529	47	6	41	481	79	402	c	TRUE	1	0.2467282749034487	0.09442285814613526	0.32223742335899264
4113	0	0.05546218487394958	A	G	595	598	33	33	0	562	205	357	c	FALSE	0	2.5000000000000004	0.14679715302491103	0.9999999999999822
4153	0	0.0429553264604811	T	C	582	583	25	1	24	557	337	220	c	FALSE	0	2.2209603259288	0.10247133764173572	0.9999999932150858
4197	0	0.035897435897435895	C	T	780	781	28	1	27	751	603	148	c	FALSE	0	4.246387011758345	0.1597730808622247	1
4210	0	0.043478260869565216	G	A	253	254	11	10	1	242	53	189	c	FALSE	0	3.5297410192147036	0.1650717703349282	0.9999954422052072
4214	0	0.17391304347826086	T	G	23	47	4	2	2	19	17	2	c	FALSE	0	2.2697368421052633	0.5415512465373962	0.8754376058723884
4218	0	0.03322259136212625	A	G	301	304	10	0	10	290	152	138	c	FALSE	0	2.027027027027027	0.06989748369058714	0.9992717524101121
4234	0	0.07017543859649122	C	T	57	67	4	1	3	49	9	40	c	FALSE	0	0.4005813953488373	0.10061699098243948	0
4238	0	0.1471861471861472	C	T	462	468	68	30	38	393	67	326	c	TRUE	1	1.3889844994302243	0.3249182547994227	0.9999970677267617
4242	0	0.04878048780487805	G	A	246	249	12	12	0	233	6	227	c	FALSE	0	13.61111111111111	0.7010014306151645	0.9999999999999998
4698	0	0.036231884057971016	A	G	690	696	25	25	0	664	248	416	c	FALSE	0	2.5238095238095237	0.09502294893861159	0.9999999999555609
4725	0	0.03626943005181347	G	T	193	195	7	7	0	185	24	161	c	FALSE	0	6.193548387096774	0.23435047951176985	0.9999984609465686
4726	0	0.05555555555555555	T	C	54	77	3	2	1	50	43	7	c	FALSE	0	1.423148148148148	0.12661111111111112	0.6057372150601896
4733	0	0.08622754491017964	T	C	835	835	72	35	37	761	522	239	c	TRUE	1	0.8239914085696032	0.13752076971467625	0.9990563703239781
4751	0	0.09935483870967741	T	C	775	777	77	43	34	698	535	163	c	TRUE	1	0.9883199459104469	0.17737193927794379	0.9998385193098428
4757	0	0.04804270462633452	T	C	562	568	27	0	27	532	429	103	c	FALSE	0	4.300000000000001	0.21823308270676692	1
4775	0	0.06321839080459771	A	G	174	179	11	0	11	163	30	133	c	FALSE	0	1.2083333333333333	0.08154396728016361	0.7848157902772942
4776	0	0.04747774480712166	G	C	337	344	16	0	16	320	122	198	c	FALSE	0	1.5700934579439252	0.07850467289719626	0.99918158986152
4867	0	0.10846560846560846	T	C	378	406	41	0	41	337	313	24	c	FALSE	0	5.815384615384615	0.7075097009815111	1
5591	0	0.09885057471264368	T	C	870	879	86	63	23	784	608	176	c	TRUE	1	0.21940360660265945	0.11621414961299396	0.58326703981551
5717	0	0.10602205258693809	C	T	1179	1180	125	35	90	1052	422	630	c	TRUE	1	0.45586214442013134	0.1291418450632743	0.9913004025186308
5806	0	0.034482758620689655	C	A	1914	1915	66	5	61	1846	1075	771	c	FALSE	0	1.9898612190278857	0.07558705220033768	1
5817	0	0.03878787878787879	G	A	825	848	32	28	4	793	15	778	c	FALSE	0	16.655917296139894	0.673974058835305	1
5828	0	0.07270083605961468	T	C	2751	2751	200	169	31	2550	1441	1109	c	TRUE	1	1.0694194725945299	0.11012350783181314	0.9999999999999997
5871	0	0.03296703296703297	G	A	728	738	24	24	0	703	103	600	c	FALSE	0	5.724409448818898	0.19542791859410177	1
5906	0	0.03558718861209965	G	A	281	296	10	10	0	266	96	170	c	FALSE	0	2.6037735849056607	0.09788622499645341	0.9999468546834464
5915	0	0.03768115942028986	A	G	345	347	13	13	0	332	218	114	c	FALSE	0	1.4935064935064934	0.05848067595055547	0.9939061694480761
5982	0	0.06417112299465241	A	G	187	190	12	6	6	175	5	170	c	FALSE	0	7.968749999999999	0.5629870129870129	0.9999932602101214
6053	0	0.03024193548387097	T	C	496	518	15	2	13	479	277	202	c	FALSE	0	1.755236586924509	0.06191158088756706	0.9992028594300365
6056	0	0.13137032842582105	C	T	883	886	116	45	71	766	359	407	c	TRUE	1	0.2824637408914748	0.15197891898282326	0.8896691771827909
6839	0	0.045454545454545456	G	A	132	139	6	6	0	124	16	108	c	FALSE	0	5.909090909090908	0.2859237536656891	0.9999874882030623
6840	0	0.035555555555555556	C	A	225	250	8	6	2	216	164	52	c	FALSE	0	0.048801742919389934	0.03705317517953683	0
6890	0	0.13131313131313133	A	G	594	627	78	49	29	516	166	350	c	TRUE	1	1.1528917544994124	0.24228314242455812	0.9999995522681705
6944	0	0.11990407673860912	G	A	417	423	50	49	1	367	0	367	c	FALSE	0	8.31733695652174	1.1331521739130435	1
6985	0	0.06406926406926407	C	A	1155	1157	74	0	74	1080	799	281	c	FALSE	0	3.250704225352113	0.22273343766301512	1
6993	0	0.030848329048843187	G	A	1167	1182	36	35	1	1131	692	439	c	FALSE	0	1.4869630799049642	0.049562559766278394	0.9999985487746182
7037	0	0.05981235340109461	C	T	2558	2558	153	106	47	2405	1317	1088	c	TRUE	1	0.5530767389958843	0.07594854504448616	0.9995907079585162
7085	0	0.03197158081705151	A	G	563	569	18	18	0	545	170	375	c	FALSE	0	2.99468085106383	0.09890689049385126	0.9999999984864153
7094	0	0.15571428571428572	C	T	700	700	109	82	27	591	533	58	c	TRUE	1	1.183666127001259	0.3260674828306957	0.9999506893692847
7108	0	0.49173553719008267	A	T	242	244	119	119	0	121	54	67	c	FALSE	0	1.3872832369942196	1.3643529355562989	1
7148	0	0.10697674418604651	T	C	860	862	92	54	38	768	399	369	c	TRUE	1	0.24154039126685256	0.12102211708999788	0.7734042629266079
7151	0	0.13996316758747698	C	T	543	543	76	47	29	467	168	299	c	TRUE	1	0.930173411051736	0.23170728670834342	0.9999739987387065
7155	0	0.042042042042042045	G	A	666	666	28	28	0	637	92	545	c	FALSE	0	5.541666666666667	0.2435897435897436	1
7156	0	0.09297520661157024	G	A	484	484	45	45	0	437	98	339	c	FALSE	0	3.3706293706293704	0.34708998095725785	1
7157	0	0.038781163434903045	C	T	361	362	14	10	4	339	310	29	c	TRUE	1	2.2683306277056277	0.12227362116742649	0.9675455656288576
7175	0	0.09670079635949944	C	T	879	883	85	52	33	794	407	387	c	TRUE	1	0.35902839567199424	0.11556350499897691	0.9126468693926209
7200	0	0.04112554112554113	C	T	462	463	19	0	19	437	415	22	c	FALSE	0	11.121951219512196	0.48356309650053025	1
7204	0	0.03943661971830986	T	C	355	356	14	2	12	341	169	172	c	FALSE	0	1.3571519378155532	0.06710084531742463	0.9879419527084843
7234	0	0.07142857142857142	T	G	98	140	7	0	7	90	9	81	c	FALSE	0	1.1022727272727273	0.08573232323232323	0
7240	0	0.07453416149068323	T	C	161	181	12	0	12	149	32	117	c	FALSE	0	1.248062015503876	0.10051506165131888	0.8738268574648227
7293	0	0.051173991571342566	C	T	1661	1664	85	3	82	1576	1334	242	c	FALSE	0	4.90175932308157	0.26613787432370717	1
7379	0	0.06183574879227053	T	C	1035	1057	64	0	64	971	709	262	c	FALSE	0	3.1748466257668713	0.20925868594137975	1
7407	0	0.14173228346456693	C	A	127	135	18	18	0	109	28	81	c	FALSE	0	2.7608695652173916	0.4559234144395692	0.9999999991350247
7410	0	0.03333333333333333	G	T	270	274	9	9	0	256	194	62	c	FALSE	0	1.3054187192118227	0.04589362684729064	0.8780875837436897
7447	0	0.07664233576642336	T	A	274	277	21	0	21	251	185	66	c	FALSE	0	3.1264367816091956	0.2615743920868251	0.9999999999936018
7451	0	0.11392405063291139	C	T	553	557	63	46	17	490	320	170	c	TRUE	1	0.3052381740906331	0.12894755517706338	0.7412223903511663
7455	0	0.037096774193548385	T	C	620	626	23	0	23	597	481	116	c	FALSE	0	4.460431654676259	0.1718424255570418	0.9999999999999998
7493	0	0.1044776119402985	G	T	268	268	28	15	13	240	137	103	c	TRUE	1	0.12811122634171637	0.11279397307924983	0.15929619452097787
7505	0	0.1111111111111111	T	C	711	729	79	43	36	632	518	114	c	TRUE	1	1.4701604278074865	0.2493048128342246	0.9999997797548408
7538	0	0.04265402843601896	A	G	633	634	27	17	10	605	171	434	c	TRUE	1	1.589433405036242	0.09233355036062968	0.9996800598532466
7568	0	0.0907563025210084	T	C	595	617	54	35	19	541	310	231	c	TRUE	1	0.28041331186258733	0.10309571646708994	0.685978688734338
8007	0	0.08842105263157894	G	A	475	475	42	23	19	433	226	207	c	TRUE	1	0.0938541354630489	0.09281028547142442	0.1283191590688899
8048	0	0.12903225806451613	G	A	155	157	20	20	0	135	1	134	c	FALSE	0	7.3809523809523805	1.09347442680776	1
8050	0	0.056	G	T	125	126	7	7	0	118	11	107	c	FALSE	0	6.944444444444445	0.4119585687382298	0.9999996009061052
8097	0	0.03508771929824561	C	T	285	285	10	0	10	275	180	95	c	FALSE	0	2.7142857142857144	0.09870129870129869	0.9999652636085121
8105	0	0.05389221556886228	C	T	668	669	36	26	10	631	380	251	c	TRUE	1	0.4766313932980601	0.06509940260418429	0.8356632638847512
8108	0	0.04885057471264368	A	G	348	358	17	17	0	328	104	224	c	FALSE	0	2.8512396694214877	0.14777766579318685	0.9999999915578047
8124	0	0.032989690721649485	A	G	485	493	16	16	0	469	179	290	c	FALSE	0	2.4871794871794872	0.0848504729101744	0.9999996818228555
8185	0	0.060240963855421686	A	G	166	166	10	0	10	155	101	54	c	FALSE	0	2.578125	0.1663306451612903	0.999951466217028
9200	0	0.04	G	A	900	903	36	30	6	864	601	263	c	TRUE	1	0.6309687225681783	0.048419927064493135	0.9061159879746721
9225	0	0.12040133779264214	C	T	897	897	108	66	42	789	251	538	c	TRUE	1	1.1277956053518983	0.21956059309467982	0.9999999934961409
9242	0	0.09405255878284924	T	C	723	726	68	30	38	654	452	202	c	TRUE	1	1.0202780489789276	0.16391669944717263	0.9999334430656397
9272	0	0.08373435996150144	C	T	1039	1039	87	44	43	952	445	507	c	TRUE	1	0.14089475247503594	0.09052482342630305	0.49703916163499384
9277	0	0.041025641025641026	C	T	780	780	32	0	32	748	651	97	c	FALSE	0	6.046511627906977	0.25867429424200966	1
9296	0	0.13110846245530394	T	C	839	839	110	63	47	727	129	598	c	TRUE	1	1.9422720665961946	0.3502449137903458	1
9344	0	0.034375	G	A	320	331	11	6	5	309	6	303	c	FALSE	0	14.073199527744983	0.5093935191022569	0.9999997238248749
9758	0	0.04451510333863275	A	G	629	629	28	4	24	594	131	463	c	TRUE	1	0.43654813511076346	0.05007532162448886	0.5188905713399332
9818	0	0.2217573221757322	G	A	239	273	53	53	0	186	5	181	c	FALSE	0	4.120689655172414	1.1741750092695589	1
9834	0	0.050505050505050504	G	A	198	202	10	10	0	187	120	67	c	FALSE	0	1.5153846153846156	0.08103661044837517	0.9830038256430019
9887	0	0.06288751107174491	C	T	1129	1130	71	41	30	1058	477	581	c	TRUE	1	0.4778491357754168	0.08031511644309779	0.9515927331042932
9899	0	0.18316831683168316	A	G	202	221	37	31	6	164	76	88	c	TRUE	1	1.2271312871829874	0.33241831523505133	0.9999615981124167
9928	0	0.04332129963898917	C	T	277	284	12	0	12	262	137	125	c	FALSE	0	2	0.0916030534351145	0.9996202991984356
9934	0	0.05191256830601093	T	C	366	381	19	1	18	344	122	222	c	FALSE	0	1.2775673940949934	0.07849900737379466	0.9948404294679448
9994	0	0.0384900074019245	T	C	1351	1368	52	0	52	1299	754	545	c	FALSE	0	2.2629815745393635	0.09058894678679515	1
10193	0	0.05263157894736842	A	G	494	495	26	6	20	468	242	226	c	FALSE	0	1.0850380277996328	0.08374129440219133	0.9953869183075057
10198	0	0.10695187165775401	G	A	187	191	20	2	18	167	26	141	c	FALSE	0	0.3906334231805931	0.11771067030359765	0.2568853365238799
10217	0	0.07741935483870968	A	G	775	777	60	34	26	713	447	266	c	TRUE	1	0.23647390804925042	0.08971042359772209	0.5942886496677638
10226	0	0.06976744186046512	A	G	172	176	12	12	0	160	115	45	c	FALSE	0	1.3543307086614174	0.1015748031496063	0.9623471771682058
10281	0	0.10243055555555555	G	A	1152	1152	118	61	57	1031	561	470	c	TRUE	1	0.09823612349343412	0.10871715538360609	0.3739521481454726
10286	0	0.13191489361702127	C	T	470	476	62	44	18	407	200	207	c	TRUE	1	0.7589317821258593	0.19117412494461675	0.9984327439300924
10310	0	0.04054054054054054	G	T	296	297	12	12	0	282	16	266	c	FALSE	0	10.5	0.44680851063829785	0.9999999999999561
10314	0	0.046462513199577615	A	G	947	948	44	32	12	903	451	452	c	TRUE	1	0.8693141254048302	0.06768392421413087	0.9968053798181735
10319	0	0.06876790830945559	C	T	698	699	48	6	42	648	596	52	c	FALSE	0	6.334205131830069	0.475122326680961	1
10324	0	0.0649895178197065	T	C	477	524	31	0	31	444	332	112	c	FALSE	0	3.3216783216783217	0.2319189819189819	1
10342	0	0.03048780487804878	A	T	328	332	10	10	0	316	221	95	c	FALSE	0	1.4112554112554112	0.04465998136884213	0.9619160957807615
10349	0	0.13043478260869565	T	C	483	485	63	36	27	418	151	267	c	TRUE	1	0.7686581125956875	0.2011840838988923	0.9978958240154717
10360	0	0.05918367346938776	C	T	490	491	29	1	28	461	280	181	c	FALSE	0	2.203522785253834	0.14189222905504156	0.9999999997407596
10361	0	0.12359550561797752	T	C	445	465	55	26	29	390	249	141	c	TRUE	1	0.6152552260573652	0.1762426984779926	0.9745625054173885
10376	0	0.10754716981132076	G	A	530	530	57	33	24	472	386	86	c	TRUE	1	1.2939420584440053	0.22527111657001225	0.9999014066748745
